1111111111111111111111111111
10000CCCCCCCCCCCCCCCCCCCCC11
100P0CCCCCCCCCCCCCCCCCCCCC11
10000CCCCCCCCCCCCCCCCCCCCC11
10000CCCCCCCCCCCCCCCCCCCCC11
11000CCCCCCCCCCCCCCCCCCCCC11
11E00CCCCCCCCCCCCCCCCCCCCC11
11000CCCCCCCCCCCCCCCCCCCCC11
1111111111111111111111111111